33 33 33 33 33 33 33 33 33 33 33 33 33 33 33 33 33 33 33 33 33 33 33 33 33 33 33 33 33 33 33 33 33 33 33 33 33 33 33 33 33 33 33 33 33 33 33 33 33 33 
33 33 33 33 33 33 33 33 33 33 33 33 33 33 33 33 33 33 33 33 33 33 33 33 33 33 33 33 33 33 33 33 33 33 33 33 33 33 33 33 33 33 33 33 33 33 33 33 33 33 
33 33 6 3 3 3 6 3 3 3 3 3 3 3 3 3 6 3 3 3 3 3 3 3 3 3 3 3 3 3 3 3 3 3 3 6 3 3 3 3 3 3 3 3 3 3 3 6 33 33 
33 33 4 33 33 33 4 33 33 33 33 33 33 33 33 33 4 33 33 33 33 33 33 33 33 33 33 33 33 33 33 33 33 33 33 4 33 33 33 33 33 33 33 33 33 33 33 4 33 33 
33 33 4 33 34 33 4 33 33 33 33 33 33 33 33 33 4 33 33 33 33 33 33 33 33 33 33 33 33 33 33 33 33 33 33 4 33 33 33 33 33 33 33 33 33 33 33 4 33 33 
33 33 4 33 33 33 4 33 33 33 33 33 33 33 33 33 4 33 33 33 33 33 33 33 33 33 33 33 33 33 33 33 33 33 33 4 33 33 33 33 33 33 33 33 33 33 33 4 33 33 
33 33 4 3 33 3 5 33 33 33 33 33 33 33 33 33 4 32 33 33 32 33 33 32 33 33 32 33 33 33 33 33 32 33 33 4 32 33 33 33 33 33 33 33 33 33 33 4 33 33 
33 33 4 33 33 33 33 33 33 33 33 33 33 33 33 33 5 3 3 3 3 3 3 3 3 3 3 6 3 33 3 6 33 33 33 5 3 3 3 3 3 3 33 33 33 33 33 4 33 33 
33 33 4 33 33 33 33 33 33 33 33 33 33 33 33 33 33 33 33 33 33 33 33 33 33 33 33 4 33 33 33 4 33 33 33 33 33 33 33 33 33 33 33 33 33 33 33 4 33 33 
33 33 4 33 33 33 33 33 33 33 33 33 33 33 33 33 33 33 33 33 33 33 33 6 33 33 33 4 33 33 33 4 32 33 33 33 33 33 33 33 33 6 33 33 32 33 33 4 33 33 
33 33 4 3 3 3 3 3 3 3 3 3 3 6 33 33 33 33 33 33 33 33 33 4 33 33 33 4 33 33 3 3 3 3 3 6 33 33 33 33 33 5 3 3 3 3 3 4 33 33 
33 33 4 33 33 33 33 33 33 33 33 33 33 4 33 33 33 33 33 33 33 33 33 4 33 33 33 5 3 33 33 33 33 33 33 4 33 33 33 33 33 33 33 33 33 33 32 4 33 33 
33 33 4 33 33 33 33 33 33 33 33 33 33 4 33 33 33 33 33 33 33 33 33 4 33 33 33 33 33 33 33 33 33 33 33 4 33 33 33 33 33 33 33 33 33 33 33 4 33 33 
33 33 4 33 33 33 33 33 32 33 33 33 33 4 33 33 33 33 33 33 33 33 33 4 33 33 33 33 33 33 33 33 33 33 32 4 33 33 33 33 33 33 33 33 33 33 33 4 33 33 
33 33 4 33 33 33 33 33 33 33 33 33 33 4 33 33 33 33 33 33 33 33 33 4 33 33 33 33 33 33 33 3 3 3 3 5 3 6 33 33 33 33 33 33 33 33 33 4 33 33 
33 33 4 33 33 33 33 33 33 33 33 33 33 4 33 33 33 33 33 33 33 33 33 4 33 33 33 33 33 33 33 33 33 33 33 33 33 4 33 33 33 33 33 33 33 33 33 4 33 33 
33 33 4 33 33 33 6 33 3 6 33 33 33 4 33 33 33 33 33 33 33 33 33 4 33 33 33 33 33 33 33 33 33 33 33 33 33 4 33 33 33 33 33 33 33 33 33 4 33 33 
33 33 4 33 33 33 4 33 33 4 33 33 33 4 33 33 33 33 33 33 33 33 33 4 32 33 33 33 33 33 33 33 33 33 33 33 32 4 33 33 33 33 33 33 33 33 32 4 33 33 
33 33 4 3 3 3 5 3 33 5 3 3 3 3 33 33 33 33 33 33 33 33 33 3 3 3 3 3 3 3 3 3 3 3 3 3 3 3 3 3 3 3 3 3 3 3 3 4 33 33 
33 33 4 33 33 33 33 33 33 33 33 33 33 33 33 33 33 33 33 33 33 33 33 33 33 33 33 33 33 33 33 33 33 33 33 33 33 33 33 33 33 33 33 33 33 33 33 4 33 33 
33 33 4 33 33 33 33 33 33 33 33 33 33 33 33 33 33 33 33 33 33 33 33 33 33 33 33 33 33 33 33 33 33 33 33 33 33 33 33 33 33 33 33 33 33 33 33 4 33 33 
33 33 4 33 33 33 33 33 33 33 33 33 33 33 33 33 33 33 33 33 33 33 33 33 33 6 3 3 3 3 3 3 3 3 3 3 3 3 3 3 3 3 3 3 6 33 33 4 33 33 
33 33 4 33 33 33 33 33 32 33 33 33 32 33 33 33 32 33 33 33 33 33 33 33 33 4 33 33 33 33 33 33 33 33 33 33 33 33 33 33 33 33 33 33 4 33 33 4 33 33 
33 33 4 33 33 33 33 33 5 5 5 5 5 5 5 5 5 33 33 33 33 33 33 33 33 4 33 33 33 32 33 33 33 33 32 33 33 33 33 33 32 33 33 33 4 33 33 4 33 33 
33 33 4 33 33 33 33 33 32 33 33 33 4 33 33 33 32 33 33 33 33 33 33 33 33 4 5 5 5 5 5 5 5 5 5 5 5 5 5 5 5 33 33 33 4 33 33 4 33 33 
33 33 4 33 33 33 33 33 33 33 33 33 4 33 33 33 33 33 33 33 33 33 33 33 33 4 33 33 33 32 33 33 33 33 32 33 33 33 33 33 32 33 33 33 4 33 33 4 33 33 
33 33 4 33 33 33 33 33 33 33 33 33 4 33 33 33 33 33 33 33 33 33 33 33 33 4 33 33 33 33 33 33 33 33 33 33 33 33 33 33 33 33 33 33 5 33 33 4 33 33 
33 33 4 33 33 33 33 33 33 33 33 33 4 33 33 33 33 33 33 33 33 33 33 33 33 6 33 33 33 33 33 33 33 33 33 33 33 33 33 33 33 33 33 33 33 33 33 4 33 33 
33 33 4 33 33 33 33 33 33 33 33 33 4 33 33 33 33 33 33 6 3 3 3 3 3 5 6 3 3 3 3 3 3 3 6 3 3 3 3 3 3 3 3 3 3 3 3 4 33 33 
33 33 4 3 3 6 33 33 33 6 3 3 4 33 33 33 33 33 33 4 32 33 33 33 33 32 4 32 33 33 33 33 33 32 4 32 33 33 33 33 33 33 33 33 33 33 33 4 33 33 
33 33 4 32 33 4 33 33 33 4 33 32 4 33 33 33 33 33 33 4 33 33 33 33 33 33 4 33 33 33 33 33 33 33 4 33 33 33 33 33 33 33 33 33 33 33 33 4 33 33 
33 33 4 33 33 4 33 33 33 4 33 33 4 33 33 33 33 33 33 4 33 33 33 33 33 33 4 33 33 33 33 33 33 33 5 33 33 33 33 33 33 33 33 33 33 33 33 4 33 33 
33 33 4 33 33 5 3 33 3 5 33 33 4 33 33 33 33 33 33 4 33 33 33 33 33 32 4 32 33 33 33 33 33 33 33 33 33 33 33 33 33 33 33 33 33 33 33 4 33 33 
33 33 4 33 33 33 33 33 33 33 33 33 4 33 33 33 33 33 33 4 33 33 33 33 6 3 5 3 3 3 3 3 3 3 3 3 3 3 3 3 3 3 3 33 3 3 3 4 33 33 
33 33 4 33 33 33 33 33 33 33 33 33 4 33 33 33 33 33 33 4 33 33 33 33 4 33 33 33 33 33 33 33 33 33 33 33 33 33 33 33 33 33 33 33 33 33 33 4 33 33 
33 33 4 5 5 5 5 5 5 5 5 5 5 33 33 33 33 33 33 4 33 33 33 33 4 33 33 33 33 33 33 33 33 33 33 33 33 33 33 33 33 33 33 33 33 33 33 4 33 33 
33 33 4 33 33 33 33 33 33 33 33 33 33 33 33 33 33 33 33 4 33 33 33 33 4 33 33 33 33 33 33 33 33 33 33 33 33 33 33 33 33 33 33 33 33 33 33 4 33 33 
33 33 4 33 33 33 33 33 6 33 33 33 33 33 33 33 33 33 33 4 33 33 33 33 4 33 33 33 33 33 33 33 33 33 33 33 33 33 33 33 33 33 33 33 33 33 33 4 33 33 
33 33 4 33 33 33 33 33 4 33 33 33 33 33 33 33 33 33 33 4 33 33 33 33 4 33 33 33 33 33 33 33 33 33 33 33 33 33 33 33 33 33 33 33 33 33 33 4 33 33 
33 33 4 33 33 33 33 33 4 33 33 33 33 33 33 33 33 33 33 4 33 33 33 33 4 33 33 33 33 33 33 33 33 33 33 33 33 33 33 33 33 33 33 33 33 33 33 4 33 33 
33 33 4 33 33 33 33 33 4 33 33 33 33 33 33 33 33 33 33 4 33 33 33 33 5 33 33 33 33 33 33 33 33 33 33 33 33 33 33 33 33 33 33 33 33 33 33 4 33 33 
33 33 4 33 33 33 33 33 4 33 33 33 33 33 33 33 33 33 33 4 33 33 33 33 33 33 33 33 33 33 33 33 33 33 33 33 33 33 33 33 33 33 33 33 33 33 33 4 33 33 
33 33 4 33 33 33 33 33 5 3 3 3 3 6 33 33 33 33 33 4 33 33 33 33 6 33 33 33 33 33 33 33 33 33 33 33 33 33 33 33 33 33 33 33 33 33 33 4 33 33 
33 33 4 33 33 33 33 33 33 33 33 33 33 4 33 33 33 33 33 5 33 33 33 33 4 33 33 33 33 33 33 33 33 33 33 33 33 33 33 33 33 33 33 33 33 33 33 4 33 33 
33 33 4 33 33 33 33 33 33 33 33 33 33 4 33 33 33 33 33 33 33 33 33 33 4 33 33 33 33 33 33 33 33 33 33 33 33 33 33 33 33 33 33 33 33 33 33 4 33 33 
33 33 4 33 33 33 33 33 33 33 33 33 33 4 33 33 33 33 33 6 33 33 33 33 4 33 33 33 33 33 33 33 33 33 33 33 33 33 33 33 33 33 33 33 33 33 33 4 33 33 
33 33 4 33 33 33 33 33 33 33 33 33 33 4 33 33 33 33 33 4 33 33 33 33 4 33 33 33 33 33 33 33 33 33 33 33 33 33 33 33 33 33 33 33 33 33 33 4 33 33 
33 33 5 3 3 3 3 3 3 3 3 3 3 5 3 3 3 3 3 5 3 3 3 3 3 3 3 3 3 3 3 3 3 3 3 3 3 3 3 3 3 3 3 3 3 3 3 5 33 33 
33 33 33 33 33 33 33 33 33 33 33 33 33 33 33 33 33 33 33 33 33 33 33 33 33 33 33 33 33 33 33 33 33 33 33 33 33 33 33 33 33 33 33 33 33 33 33 33 33 33 
33 33 33 33 33 33 33 33 33 33 33 33 33 33 33 33 33 33 33 33 33 33 33 33 33 33 33 33 33 33 33 33 33 33 33 33 33 33 33 33 33 33 33 33 33 33 33 33 33 33 
