15 12 12 12 12 12 12 12 12 12 12 12 12 12 12 12 12 12 12 12 12 15 12 12 12 12 12 12 12 12 12 12 12 12 12 12 12 12 12 12 12 12 12 12 12 12 12 12 15 15 
10 6 3 3 3 6 28 28 28 28 28 28 28 28 28 28 28 28 28 28 0 17 1 28 28 28 27 28 28 28 28 28 28 28 28 28 28 28 28 28 28 28 28 28 28 28 28 28 14 15 
10 4 2 2 2 4 28 28 28 28 28 28 28 28 28 27 28 28 28 28 1 17 0 28 28 28 28 28 28 27 28 28 28 27 28 28 28 28 28 28 28 28 28 28 28 28 28 28 14 15 
10 4 2 2 2 4 28 28 28 27 28 27 28 28 28 28 28 7 8 8 8 15 8 8 8 9 28 28 28 28 18 0 1 0 0 0 0 0 0 0 0 0 0 0 19 28 28 28 14 15 
10 4 2 2 2 4 28 28 28 28 28 28 28 28 28 28 28 14 15 15 16 15 16 15 16 10 28 27 28 28 0 0 0 0 0 0 0 0 0 0 0 27 0 0 0 19 28 28 14 15 
10 5 3 2 3 5 28 28 28 7 8 8 9 28 28 28 28 14 15 16 15 16 15 16 15 10 28 28 28 28 0 0 22 2 2 2 2 2 2 23 0 0 0 0 0 0 28 28 14 15 
10 27 27 2 2 28 28 28 28 14 15 15 10 28 28 27 28 13 12 12 12 12 12 12 12 11 28 28 28 18 0 0 2 2 2 2 2 2 2 2 0 0 27 1 30 30 28 28 14 15 
10 27 27 2 2 28 28 28 28 13 12 12 11 28 28 28 28 28 28 28 28 28 28 28 28 28 28 18 0 0 0 0 2 2 2 2 2 2 2 2 0 0 0 0 0 34 28 28 14 15 
10 27 27 2 2 28 28 28 28 28 28 31 0 28 28 28 28 22 2 2 2 2 2 2 2 2 23 0 0 0 0 0 25 2 2 2 2 2 2 24 0 0 0 0 30 30 28 28 14 15 
10 27 27 2 2 2 23 28 27 28 28 28 0 28 28 27 28 2 2 2 2 2 2 2 2 2 2 0 0 0 0 0 0 0 0 0 0 0 0 0 0 0 0 0 1 20 28 28 14 15 
10 27 27 25 2 2 2 28 28 27 27 27 0 0 0 0 28 2 2 2 2 2 2 2 2 2 24 0 0 0 27 1 0 0 27 0 0 0 0 0 0 0 0 0 20 28 28 28 14 15 
10 27 27 1 1 2 2 28 28 28 28 28 28 27 28 0 28 2 2 2 2 2 2 28 28 28 28 28 28 21 0 0 0 0 0 0 1 0 0 0 27 1 0 0 28 28 28 28 14 15 
10 27 27 1 1 2 2 23 1 28 28 28 28 28 28 0 28 2 2 2 2 2 2 28 28 28 28 28 28 28 0 0 0 0 0 0 0 0 0 0 0 0 0 0 28 28 28 28 14 15 
10 27 27 1 1 2 2 2 1 28 28 0 0 28 26 0 0 2 2 2 2 2 2 28 27 28 28 7 8 8 8 8 8 8 8 8 8 8 8 8 8 8 8 9 28 28 27 28 14 15 
10 27 27 1 1 2 2 2 1 28 28 28 0 28 28 28 28 2 2 2 2 2 2 28 28 28 27 14 28 27 28 27 28 27 28 26 28 27 28 27 28 27 28 10 28 28 28 28 14 15 
10 27 27 1 1 2 2 2 1 28 28 28 0 28 28 28 28 2 2 2 2 2 2 28 28 27 28 13 12 12 12 12 12 12 12 12 12 12 12 12 12 12 12 11 28 27 28 28 14 15 
10 27 27 1 1 2 2 2 1 28 28 28 0 27 27 28 27 2 2 2 2 2 2 28 27 27 28 28 28 28 28 28 28 28 28 28 28 28 28 28 28 28 28 28 28 28 28 28 14 15 
10 27 27 1 1 2 2 2 1 0 0 0 0 28 28 27 27 2 2 2 2 2 2 28 28 28 27 28 28 27 28 22 2 2 2 2 2 2 2 2 2 23 28 28 28 27 27 28 14 15 
10 27 27 1 1 2 2 2 1 27 27 28 28 28 28 27 27 1 2 2 2 2 18 0 0 0 0 0 0 0 22 2 2 2 2 2 2 2 2 2 2 2 23 28 28 27 28 28 14 15 
10 27 27 1 1 2 2 2 1 27 27 27 27 27 27 27 27 27 2 2 2 2 0 0 0 0 27 0 0 1 2 2 2 2 2 1 0 0 0 2 2 2 2 28 28 28 28 28 14 15 
10 27 27 1 1 2 2 2 1 27 27 27 27 27 27 27 27 1 2 2 2 2 21 0 0 0 0 0 0 0 25 2 2 2 2 0 0 1 0 2 2 2 24 28 27 28 27 28 14 15 
10 27 27 1 1 2 2 2 1 27 27 27 27 27 27 27 27 1 6 3 2 3 6 0 0 0 0 0 0 0 0 25 2 2 2 2 2 2 2 2 2 24 28 28 28 28 28 28 14 15 
10 27 27 27 28 2 2 2 2 28 28 28 28 28 28 28 28 28 4 2 2 2 4 0 0 0 0 0 0 0 27 27 28 28 28 28 2 2 28 28 28 28 28 28 27 27 27 28 14 15 
10 27 28 28 28 2 2 2 2 28 7 8 8 8 8 8 9 28 4 2 2 2 4 0 0 27 0 0 0 28 28 28 28 28 28 2 2 2 28 28 28 28 28 28 28 28 27 28 14 15 
10 27 27 27 27 2 2 2 2 28 14 15 15 15 15 15 10 28 4 2 2 2 4 28 0 0 0 0 28 7 8 8 8 8 28 2 2 2 28 8 8 8 8 8 8 8 8 8 16 15 
10 27 27 27 27 2 2 2 2 28 14 15 15 15 15 15 10 28 5 3 3 3 5 28 28 28 28 28 28 14 15 12 12 12 28 2 2 28 28 12 12 12 12 12 12 12 12 12 16 15 
10 27 27 27 27 2 2 2 2 28 14 15 15 15 15 15 15 8 8 8 8 8 8 8 8 8 8 8 8 15 10 28 28 28 28 2 2 2 28 28 28 28 28 27 28 28 28 28 14 15 
10 27 27 26 27 2 2 2 2 28 13 12 12 12 12 12 12 12 12 12 12 12 12 12 12 12 12 12 12 12 11 28 28 27 28 28 2 2 28 28 27 28 28 28 27 28 28 28 14 16 
10 27 27 27 27 25 2 2 24 28 28 28 28 28 28 28 28 28 28 28 28 28 28 28 28 28 28 28 28 28 28 28 28 28 28 2 2 2 28 28 28 28 28 28 28 28 28 28 14 16 
10 27 27 27 27 0 0 0 0 27 27 27 27 27 27 27 27 27 6 3 3 3 6 28 28 27 27 28 27 28 28 27 6 0 0 25 2 24 28 6 3 3 3 3 3 3 6 28 14 16 
10 27 27 27 18 0 0 27 0 1 19 27 27 27 27 27 27 27 4 2 2 2 4 28 27 28 28 28 28 28 28 27 4 0 0 0 0 28 28 4 29 0 0 0 0 29 4 28 14 15 
10 27 27 18 0 0 0 0 0 0 0 19 27 27 27 27 27 27 4 2 2 2 4 28 27 28 27 27 27 27 27 27 4 27 0 0 0 28 28 4 0 0 0 0 0 1 4 28 14 15 
10 27 27 0 0 0 0 0 0 0 0 0 27 27 27 27 27 27 4 2 2 2 4 28 28 28 27 1 0 0 27 27 4 0 0 1 0 28 28 4 0 26 0 0 27 0 4 28 14 15 
10 27 27 0 1 0 0 0 27 0 0 0 29 29 29 29 29 29 5 5 2 5 5 28 27 28 27 0 26 1 27 27 4 0 0 0 27 27 28 4 0 0 0 0 0 0 4 27 14 15 
10 27 27 0 0 0 0 0 0 0 0 0 22 2 2 2 2 2 2 2 2 29 29 28 28 28 27 0 0 0 27 27 4 0 0 0 0 28 28 4 0 1 0 0 0 0 4 28 14 15 
10 27 27 0 1 0 0 0 0 1 0 0 25 2 2 2 2 2 2 2 24 30 30 28 28 28 27 0 0 0 27 27 4 0 1 0 0 28 27 4 0 0 0 0 26 0 4 28 14 15 
10 27 27 21 0 0 0 0 0 0 0 0 29 29 29 29 29 29 29 29 28 28 28 28 28 28 27 0 0 1 27 27 4 0 26 0 0 28 28 4 0 0 27 0 0 0 4 28 14 15 
10 27 27 27 21 0 0 0 0 0 1 20 28 28 28 28 28 28 28 28 28 28 27 27 27 27 27 0 0 27 27 27 4 0 0 0 0 27 28 4 0 0 0 0 0 0 4 28 14 15 
10 27 27 27 27 0 0 0 0 0 20 28 28 28 27 28 27 28 28 28 28 28 6 3 3 3 27 0 0 27 5 5 5 1 0 0 0 28 28 4 0 0 0 0 1 0 4 27 14 15 
10 27 27 27 27 0 0 27 0 20 28 28 28 28 28 28 26 28 28 27 28 28 4 0 0 0 0 0 0 27 28 28 28 1 22 2 23 28 27 4 1 0 0 0 0 0 4 28 14 15 
10 27 27 27 27 0 0 0 0 28 28 28 28 27 28 28 28 28 28 27 28 28 4 0 0 0 0 0 0 1 28 28 28 1 2 2 2 28 28 4 0 0 0 0 27 0 4 28 14 15 
10 27 27 27 27 22 2 2 23 28 28 28 28 28 28 28 28 28 28 28 28 28 5 29 1 1 1 1 1 1 1 1 1 1 2 2 2 28 28 4 0 0 0 1 0 0 4 28 14 15 
10 27 27 27 27 2 2 2 2 2 2 2 2 2 2 2 2 2 2 2 2 2 2 2 2 2 2 2 2 2 2 2 2 2 2 2 2 0 28 4 0 0 27 0 0 0 4 28 14 15 
10 27 27 27 27 2 2 2 2 2 2 2 2 2 2 2 2 2 2 2 2 2 2 2 2 2 2 2 2 2 2 2 2 2 2 2 24 0 28 4 0 0 0 0 0 0 4 28 14 15 
10 27 27 27 27 25 2 2 2 2 2 2 2 24 30 28 28 28 27 28 28 28 27 27 27 27 27 27 0 0 29 0 0 29 0 0 0 29 28 5 29 0 0 0 0 29 5 28 14 15 
10 27 27 27 27 1 1 1 1 1 1 1 29 29 30 28 28 27 28 28 28 28 3 3 3 3 3 3 28 27 28 28 28 28 0 0 0 0 1 1 1 1 1 1 1 1 28 28 14 15 
10 27 27 27 27 29 29 29 29 29 29 29 28 28 28 28 28 28 28 27 27 28 28 28 28 28 28 26 28 28 28 28 27 28 0 0 0 0 1 1 1 1 1 1 1 1 28 28 14 15 
10 27 27 27 27 27 27 27 27 27 27 27 27 28 28 28 28 27 28 28 28 28 28 28 28 28 28 28 28 28 28 27 28 28 28 28 28 28 28 28 28 28 28 28 28 28 28 28 14 15 
15 8 8 8 8 8 8 8 8 8 8 8 8 8 8 8 8 8 8 8 8 8 8 8 8 8 8 8 8 8 8 8 8 8 8 8 8 8 8 8 8 8 8 8 8 8 8 8 15 15 
15 15 15 15 15 15 15 15 15 15 15 15 15 15 15 15 15 15 15 15 15 15 15 15 15 15 15 15 15 15 15 15 15 15 15 15 15 15 15 15 15 15 15 15 15 15 15 15 15 15 
